111111111
1P00C0001
1000C0001
111100001
1000000E1
111111111