1111111111111111111
10000000C0000001111
1001011111000001111
10010000C0000P01111
1001000000000C01111
100011111011000CE11
1111111111111111111