1111111111111111111111111111111111
1ES0S0000S00000C00000C00000S000001
1010010100100S0010100100SS00010101
1010S1S010101010001001000S00010101
1P0000000C00C00000S000000000000SC1
1111111111111111111111111111111111