1111111111111111111111111111111111
1C1S0001000000S00S0S000000000SS001
1000010111111001010S001110S1000011
1011110100001001000000001110001001
100S010000001100011101100010011001
1011110S01000000000S010SS011110001
101S000101111111110001001000100011
10111001000000000SS001011000101001
1010000111111111S11011010011101001
101S100000000001001010010010001111
101111110001000100101011E010000001
100S000111110100000010011111110101
1C0010010S0101S1011111111000000001
1111100110010101110000000001001001
1P000000000001000001100C10010C10C1
1111111111111111111111111111111111