111111111111111
1P0000000111111
100000E11111111
100P00000000C11
1100000000CCC11
111111111111111