111111111
110011011
100000001
1PE011111
111111111