111111111111111
1P0000000111111
100E00E11111111
100000000000C11
1100000000CCC11
111111111111111